1111111111111
100100C000001
1000011111E11
1P001100C0001
1111111111111